Зашифрованный алфавит- расшифрованный алфавит
е -  
ж - о
ь - а
щ - и
г - т
д - н
м - с
х - е
ш - р
з - л
я - к
ч - д
а - п
й - в
ы - м
э - у
ц - ь
к - я
н - ы
т - х
о - з
л - й
п - г
и - ч
в - ж
  - б
б - ц
р - э
ю - ш
ф - ю
